Judet,Unitate administrativ teritoriala,Denumire,Populatie,Barbati,Femei
Alba,MUNICIPIU,ALBA IULIA,58681,27874,30807
Alba,MUNICIPIU,AIUD,22495,11501,10994
Alba,MUNICIPIU,BLAJ,20026,9767,10259
Alba,MUNICIPIU,SEBES,24165,11623,12542
Alba,ORAS,ABRUD,4944,2491,2453
Alba,ORAS,BAIA DE ARIES,3433,1717,1716
Alba,ORAS,CAMPENI,6942,3449,3493
Alba,ORAS,CUGIR,20119,9802,10317
Alba,ORAS,OCNA MURES,12377,6056,6321
Alba,ORAS,TEIUS,6421,3155,3266
Alba,ORAS,ZLATNA,7182,3532,3650
Alba,COMUNA,ALBAC,2043,1038,1005
Alba,COMUNA,ALMASU MARE,1303,665,638
Alba,COMUNA,ARIESENI,1743,880,863
Alba,COMUNA,AVRAM IANCU,1613,805,808
Alba,COMUNA,BERGHIN,1838,918,920
Alba,COMUNA,BISTRA,4417,2325,2092
Alba,COMUNA,BLANDIANA,879,450,429
Alba,COMUNA,BUCERDEA GRANOASA,2187,1127,1060
Alba,COMUNA,BUCIUM,1454,715,739
Alba,COMUNA,CALNIC,1615,791,824
Alba,COMUNA,CENADE,929,467,462
Alba,COMUNA,CERGAU,1445,772,673
Alba,COMUNA,CERU-BACAINTI,266,136,130
Alba,COMUNA,CETATEA DE BALTA,2798,1356,1442
Alba,COMUNA,CIUGUD,3018,1494,1524
Alba,COMUNA,CIURULEASA,1181,592,589
Alba,COMUNA,CRACIUNELU DE JOS,1917,975,942
Alba,COMUNA,CRICAU,1850,908,942
Alba,COMUNA,CUT,1074,512,562
Alba,COMUNA,DAIA ROMANA,2725,1349,1376
Alba,COMUNA,DOSTAT,938,458,480
Alba,COMUNA,FARAU,1530,783,747
Alba,COMUNA,GALDA DE JOS,4396,2232,2164
Alba,COMUNA,GARBOVA,2012,987,1025
Alba,COMUNA,GARDA DE SUS,1694,836,858
Alba,COMUNA,HOPARTA,1103,557,546
Alba,COMUNA,HOREA,2125,1096,1029
Alba,COMUNA,IGHIU,6094,3049,3045
Alba,COMUNA,INTREGALDE,562,285,277
Alba,COMUNA,JIDVEI,4507,2244,2263
Alba,COMUNA,LIVEZILE,1173,594,579
Alba,COMUNA,LOPADEA NOUA,2731,1417,1314
Alba,COMUNA,LUNCA MURESULUI,2359,1206,1153
Alba,COMUNA,LUPSA,2996,1517,1479
Alba,COMUNA,METES,2848,1459,1389
Alba,COMUNA,MIHALT,2986,1513,1473
Alba,COMUNA,MIRASLAU,1906,941,965
Alba,COMUNA,MOGOS,703,362,341
Alba,COMUNA,NOSLAC,1588,813,775
Alba,COMUNA,OCOLIS,608,301,307
Alba,COMUNA,OHABA,734,354,380
Alba,COMUNA,PIANU,3028,1507,1521
Alba,COMUNA,POIANA VADULUI,1147,603,544
Alba,COMUNA,PONOR,531,280,251
Alba,COMUNA,POSAGA,1015,504,511
Alba,COMUNA,RADESTI,1165,613,552
Alba,COMUNA,RAMET,547,243,304
Alba,COMUNA,RAMETEA,1089,553,536
Alba,COMUNA,ROSIA DE SECAS,1510,750,760
Alba,COMUNA,ROSIA MONTANA,2609,1298,1311
Alba,COMUNA,SALCIUA,1415,711,704
Alba,COMUNA,SALISTEA,2107,1051,1056
Alba,COMUNA,SANCEL,2342,1214,1128
Alba,COMUNA,SANTIMBRU,2669,1328,1341
Alba,COMUNA,SASCIORI,5600,2864,2736
Alba,COMUNA,SCARISOARA,1634,832,802
Alba,COMUNA,SIBOT,2157,1069,1088
Alba,COMUNA,SOHODOL,1703,864,839
Alba,COMUNA,SONA,3940,1973,1967
Alba,COMUNA,SPRING,2313,1153,1160
Alba,COMUNA,STREMT,2379,1195,1184
Alba,COMUNA,SUGAG,2660,1365,1295
Alba,COMUNA,UNIREA,4574,2259,2315
Alba,COMUNA,VADU MOTILOR,1322,678,644
Alba,COMUNA,VALEA LUNGA,2864,1454,1410
Alba,COMUNA,VIDRA,1637,818,819
Alba,COMUNA,VINTU DE JOS,4628,2274,2354
Arad,MUNICIPIU,ARAD,147922,69861,78061
Arad,ORAS,CHISINEU-CRIS,7577,3647,3930
Arad,ORAS,CURTICI,6849,3300,3549
Arad,ORAS,INEU,9078,4388,4690
Arad,ORAS,LIPOVA,9648,4648,5000
Arad,ORAS,NADLAC,7185,3489,3696
Arad,ORAS,PANCOTA,6651,3217,3434
Arad,ORAS,PECICA,11885,5769,6116
Arad,ORAS,SANTANA,10725,5235,5490
Arad,ORAS,SEBIS,5831,2807,3024
Arad,COMUNA,ALMAS,2503,1205,1298
Arad,COMUNA,APATEU,3084,1541,1543
Arad,COMUNA,ARCHIS,1494,748,746
Arad,COMUNA,BARSA,1793,874,919
Arad,COMUNA,BARZAVA,2699,1285,1414
Arad,COMUNA,BATA,1069,531,538
Arad,COMUNA,BELIU,3022,1477,1545
Arad,COMUNA,BIRCHIS,1818,864,954
Arad,COMUNA,BOCSIG,3103,1487,1616
Arad,COMUNA,BRAZII,1154,575,579
Arad,COMUNA,BUTENI,3367,1613,1754
Arad,COMUNA,CARAND,1001,489,512
Arad,COMUNA,CERMEI,2667,1314,1353
Arad,COMUNA,CHISINDIA,1311,631,680
Arad,COMUNA,CONOP,2194,1075,1119
Arad,COMUNA,COVASINT,2463,1216,1247
Arad,COMUNA,CRAIVA,2728,1324,1404
Arad,COMUNA,DEZNA,1185,581,604
Arad,COMUNA,DIECI,1470,731,739
Arad,COMUNA,DOROBANTI,1618,788,830
Arad,COMUNA,FANTINELE,2950,1496,1454
Arad,COMUNA,FELNAC,2838,1405,1433
Arad,COMUNA,FRUMUSENI,2484,1244,1240
Arad,COMUNA,GHIOROC,3667,1736,1931
Arad,COMUNA,GRANICERI,2173,1079,1094
Arad,COMUNA,GURAHONT,3949,1890,2059
Arad,COMUNA,HALMAGEL,1284,598,686
Arad,COMUNA,HALMAGIU,2801,1357,1444
Arad,COMUNA,HASMAS,1278,614,664
Arad,COMUNA,IGNESTI,669,338,331
Arad,COMUNA,IRATOSU,2277,1105,1172
Arad,COMUNA,LIVADA,2831,1379,1452
Arad,COMUNA,MACEA,5449,2680,2769
Arad,COMUNA,MISCA,3588,1743,1845
Arad,COMUNA,MONEASA,884,428,456
Arad,COMUNA,OLARI,1863,923,940
Arad,COMUNA,PAULIS,4008,1960,2048
Arad,COMUNA,PEREGU MARE,1584,763,821
Arad,COMUNA,PETRIS,1517,763,754
Arad,COMUNA,PILU,2027,1007,1020
Arad,COMUNA,PLESCUTA,1215,581,634
Arad,COMUNA,SAGU,3671,1805,1866
Arad,COMUNA,SAVARSIN,2850,1381,1469
Arad,COMUNA,SECUSIGIU,5252,2596,2656
Arad,COMUNA,SEITIN,2868,1435,1433
Arad,COMUNA,SELEUS,3003,1445,1558
Arad,COMUNA,SEMLAC,3449,1702,1747
Arad,COMUNA,SEPREUS,2321,1143,1178
Arad,COMUNA,SICULA,4231,2056,2175
Arad,COMUNA,SILINDIA,884,427,457
Arad,COMUNA,SIMAND,3768,1869,1899
Arad,COMUNA,SINTEA MARE,3661,1783,1878
Arad,COMUNA,SIRIA,7613,3767,3846
Arad,COMUNA,SISTAROVAT,326,161,165
Arad,COMUNA,SOCODOR,2340,1167,1173
Arad,COMUNA,SOFRONEA,2523,1249,1274
Arad,COMUNA,TARNOVA,5681,2807,2874
Arad,COMUNA,TAUT,1714,827,887
Arad,COMUNA,USUSAU,1352,692,660
Arad,COMUNA,VARADIA DE MURES,1720,831,889
Arad,COMUNA,VARFURILE,2679,1314,1365
Arad,COMUNA,VINGA,5828,2827,3001
Arad,COMUNA,VLADIMIRESCU,10076,4894,5182
Arad,COMUNA,ZABRANI,4140,1999,2141
Arad,COMUNA,ZADARENI,2408,1199,1209
Arad,COMUNA,ZARAND,2505,1225,1280
Arad,COMUNA,ZERIND,1303,630,673
Arad,COMUNA,ZIMANDU NOU,4476,2186,2290
Arges,MUNICIPIU,PITESTI,148264,70460,77804
Arges,MUNICIPIU,CAMPULUNG,30025,14403,15622
Arges,MUNICIPIU,CURTEA DE ARGES,26133,12617,13516
Arges,ORAS,COSTESTI,10058,4942,5116
Arges,ORAS,MIOVENI,30644,15665,14979
Arges,ORAS,STEFANESTI,13682,6672,7010
Arges,ORAS,TOPOLOVENI,10037,4717,5320
Arges,COMUNA,ALBESTII DE ARGES,5308,2599,2709
Arges,COMUNA,ALBESTII DE MUSCEL,1561,754,807
Arges,COMUNA,ALBOTA,3667,1792,1875
Arges,COMUNA,ANINOASA,3236,1590,1646
Arges,COMUNA,AREFU,2360,1174,1186
Arges,COMUNA,BABANA,2745,1373,1372
Arges,COMUNA,BAICULESTI,5618,2824,2794
Arges,COMUNA,BALILESTI,4045,2004,2041
Arges,COMUNA,BARLA,5006,2438,2568
Arges,COMUNA,BASCOV,9911,4872,5039
Arges,COMUNA,BELETI-NEGRESTI,1915,978,937
Arges,COMUNA,BEREVOESTI,3284,1616,1668
Arges,COMUNA,BOGATI,4565,2287,2278
Arges,COMUNA,BOTENI,2466,1208,1258
Arges,COMUNA,BOTESTI,1184,603,581
Arges,COMUNA,BRADU,6856,3343,3513
Arges,COMUNA,BRADULET,1805,869,936
Arges,COMUNA,BUDEASA,3928,1949,1979
Arges,COMUNA,BUGHEA DE JOS,2809,1404,1405
Arges,COMUNA,BUGHEA DE SUS,2894,1415,1479
Arges,COMUNA,BUZOESTI,5867,2858,3009
Arges,COMUNA,CALDARARU,2440,1152,1288
Arges,COMUNA,CALINESTI,10294,5073,5221
Arges,COMUNA,CATEASCA,3886,1953,1933
Arges,COMUNA,CEPARI,2240,1115,1125
Arges,COMUNA,CETATENI,3018,1477,1541
Arges,COMUNA,CICANESTI,2090,1044,1046
Arges,COMUNA,CIOFRANGENI,2252,1072,1180
Arges,COMUNA,CIOMAGESTI,1147,572,575
Arges,COMUNA,COCU,2337,1161,1176
Arges,COMUNA,CORBENI,5187,2529,2658
Arges,COMUNA,CORBI,3719,1807,1912
Arges,COMUNA,COSESTI,5246,2655,2591
Arges,COMUNA,COTMEANA,2080,1009,1071
Arges,COMUNA,CUCA,2054,1017,1037
Arges,COMUNA,DAMBOVICIOARA,939,458,481
Arges,COMUNA,DARMANESTI,3410,1683,1727
Arges,COMUNA,DAVIDESTI,3049,1504,1545
Arges,COMUNA,DOBRESTI,1756,877,879
Arges,COMUNA,DOMNESTI,3178,1556,1622
Arges,COMUNA,DRAGANU,1939,957,982
Arges,COMUNA,DRAGOSLAVELE,2561,1295,1266
Arges,COMUNA,GODENI,3019,1489,1530
Arges,COMUNA,HARSESTI,2393,1172,1221
Arges,COMUNA,HARTIESTI,2127,1065,1062
Arges,COMUNA,IZVORU,2210,1048,1162
Arges,COMUNA,LEORDENI,5816,2874,2942
Arges,COMUNA,LERESTI,4588,2207,2381
Arges,COMUNA,LUNCA CORBULUI,2849,1332,1517
Arges,COMUNA,MALURENI,4660,2307,2353
Arges,COMUNA,MARACINENI,5091,2486,2605
Arges,COMUNA,MERISANI,4312,2141,2171
Arges,COMUNA,MICESTI,4283,2141,2142
Arges,COMUNA,MIHAESTI,5705,2800,2905
Arges,COMUNA,MIOARELE,1601,778,823
Arges,COMUNA,MIROSI,2521,1255,1266
Arges,COMUNA,MORARESTI,2063,976,1087
Arges,COMUNA,MOSOAIA,5561,2788,2773
Arges,COMUNA,MOZACENI,2193,1043,1150
Arges,COMUNA,MUSATESTI,3797,1822,1975
Arges,COMUNA,NEGRASI,2337,1097,1240
Arges,COMUNA,NUCSOARA,1409,697,712
Arges,COMUNA,OARJA,2891,1444,1447
Arges,COMUNA,PIETROSANI,5610,2776,2834
Arges,COMUNA,POIANA LACULUI,6548,3235,3313
Arges,COMUNA,POIENARII DE ARGES,1108,523,585
Arges,COMUNA,POIENARII DE MUSCEL,3224,1590,1634
Arges,COMUNA,POPESTI,2133,1029,1104
Arges,COMUNA,PRIBOIENI,3490,1727,1763
Arges,COMUNA,RACA,1240,578,662
Arges,COMUNA,RATESTI,3061,1484,1577
Arges,COMUNA,RECEA,2921,1435,1486
Arges,COMUNA,ROCIU,2596,1196,1400
Arges,COMUNA,RUCAR,5673,2921,2752
Arges,COMUNA,SALATRUCU,2178,1094,1084
Arges,COMUNA,SAPATA,1727,841,886
Arges,COMUNA,SCHITU GOLESTI,4586,2253,2333
Arges,COMUNA,SLOBOZIA,4546,2309,2237
Arges,COMUNA,STALPENI,4770,2335,2435
Arges,COMUNA,STEFAN CEL MARE,2400,1181,1219
Arges,COMUNA,STOENESTI,4304,2126,2178
Arges,COMUNA,STOLNICI,3237,1559,1678
Arges,COMUNA,SUICI,2527,1263,1264
Arges,COMUNA,SUSENI,3409,1647,1762
Arges,COMUNA,TEIU,1558,728,830
Arges,COMUNA,TIGVENI,3368,1563,1805
Arges,COMUNA,TITESTI,4808,2375,2433
Arges,COMUNA,UDA,2102,1023,1079
Arges,COMUNA,UNGHENI,3060,1451,1609
Arges,COMUNA,VALEA DANULUI,2721,1352,1369
Arges,COMUNA,VALEA IASULUI,2478,1236,1242
Arges,COMUNA,VALEA MARE PRAVAT,4004,1999,2005
Arges,COMUNA,VEDEA,3943,1898,2045
Arges,COMUNA,VLADESTI,3050,1552,1498
Arges,COMUNA,VULTURESTI,2852,1468,1384
Bacau,MUNICIPIU,BACAU,133460,63904,69556
Bacau,MUNICIPIU,MOINESTI,20855,10221,10634
Bacau,MUNICIPIU,ONESTI,36004,17085,18919
Bacau,ORAS,BUHUSI,13191,6404,6787
Bacau,ORAS,COMANESTI,18390,9055,9335
Bacau,ORAS,DARMANESTI,11508,5713,5795
Bacau,ORAS,SLANIC MOLDOVA,4056,2032,2024
Bacau,ORAS,TARGU OCNA,10602,5245,5357
Bacau,COMUNA,AGAS,5651,2826,2825
Bacau,COMUNA,ARDEOANI,2124,1070,1054
Bacau,COMUNA,ASAU,6520,3292,3228
Bacau,COMUNA,BALCANI,7084,3601,3483
Bacau,COMUNA,BARSANESTI,4477,2269,2208
Bacau,COMUNA,BERESTI-BISTRITA,1864,923,941
Bacau,COMUNA,BERESTI-TAZLAU,5174,2661,2513
Bacau,COMUNA,BERZUNTI,4497,2306,2191
Bacau,COMUNA,BLAGESTI,6585,3203,3382
Bacau,COMUNA,BOGDANESTI,2515,1243,1272
Bacau,COMUNA,BRUSTUROASA,3086,1593,1493
Bacau,COMUNA,BUCIUMI,2808,1442,1366
Bacau,COMUNA,BUHOCI,3874,1965,1909
Bacau,COMUNA,CAIUTI,5100,2560,2540
Bacau,COMUNA,CASIN,3300,1628,1672
Bacau,COMUNA,CLEJA,6621,3369,3252
Bacau,COMUNA,COLONESTI,2034,1069,965
Bacau,COMUNA,CORBASCA,4537,2301,2236
Bacau,COMUNA,COTOFANESTI,3079,1512,1567
Bacau,COMUNA,DAMIENESTI,1669,820,849
Bacau,COMUNA,DEALU MORII,2722,1351,1371
Bacau,COMUNA,DOFTEANA,9015,4544,4471
Bacau,COMUNA,FARAOANI,3840,1836,2004
Bacau,COMUNA,FILIPENI,2172,1117,1055
Bacau,COMUNA,FILIPESTI,4189,2045,2144
Bacau,COMUNA,GAICEANA,3009,1523,1486
Bacau,COMUNA,GARLENI,5664,2848,2816
Bacau,COMUNA,GHIMES-FAGET,5063,2606,2457
Bacau,COMUNA,GIOSENI,3080,1593,1487
Bacau,COMUNA,GLAVANESTI,3208,1595,1613
Bacau,COMUNA,GURA VAII,4544,2292,2252
Bacau,COMUNA,HELEGIU,6314,3257,3057
Bacau,COMUNA,HEMEIUS,4494,2267,2227
Bacau,COMUNA,HORGESTI,4330,2269,2061
Bacau,COMUNA,HURUIESTI,2501,1247,1254
Bacau,COMUNA,ITESTI,1557,805,752
Bacau,COMUNA,IZVORU BERHECIU,1467,740,727
Bacau,COMUNA,LETEA VECHE,5491,2748,2743
Bacau,COMUNA,LIPOVA,2814,1456,1358
Bacau,COMUNA,LIVEZI,4859,2466,2393
Bacau,COMUNA,LUIZI-CALUGARA,3333,1607,1726
Bacau,COMUNA,MAGIRESTI,3883,1959,1924
Bacau,COMUNA,MAGURA,3987,1924,2063
Bacau,COMUNA,MANASTIREA CASIN,4607,2296,2311
Bacau,COMUNA,MARGINENI,7428,3690,3738
Bacau,COMUNA,MOTOSENI,3386,1713,1673
Bacau,COMUNA,NEGRI,2548,1278,1270
Bacau,COMUNA,NICOLAE BALCESCU,6637,3273,3364
Bacau,COMUNA,ODOBESTI,2271,1167,1104
Bacau,COMUNA,OITUZ,7927,3973,3954
Bacau,COMUNA,ONCESTI,1587,825,762
Bacau,COMUNA,ORBENI,3686,1813,1873
Bacau,COMUNA,PALANCA,3261,1672,1589
Bacau,COMUNA,PANCESTI,3772,1941,1831
Bacau,COMUNA,PARAVA,2577,1270,1307
Bacau,COMUNA,PARGARESTI,4330,2161,2169
Bacau,COMUNA,PARINCEA,3436,1752,1684
Bacau,COMUNA,PARJOL,5404,2720,2684
Bacau,COMUNA,PLOPANA,2863,1445,1418
Bacau,COMUNA,PODU TURCULUI,4387,2147,2240
Bacau,COMUNA,PODURI,6747,3435,3312
Bacau,COMUNA,PRAJESTI,1686,798,888
Bacau,COMUNA,RACACIUNI,7006,3582,3424
Bacau,COMUNA,RACHITOASA,5000,2496,2504
Bacau,COMUNA,RACOVA,3175,1617,1558
Bacau,COMUNA,ROSIORI,2034,1018,1016
Bacau,COMUNA,SANDULENI,3787,1930,1857
Bacau,COMUNA,SARATA,1860,948,912
Bacau,COMUNA,SASCUT,8128,3969,4159
Bacau,COMUNA,SAUCESTI,4530,2288,2242
Bacau,COMUNA,SCORTENI,2537,1272,1265
Bacau,COMUNA,SECUIENI,2049,1037,1012
Bacau,COMUNA,SOLONT,3208,1596,1612
Bacau,COMUNA,STANISESTI,4342,2248,2094
Bacau,COMUNA,STEFAN CEL MARE,4556,2246,2310
Bacau,COMUNA,STRUGARI,2376,1216,1160
Bacau,COMUNA,TAMASI,2631,1363,1268
Bacau,COMUNA,TARGU TROTUS,4836,2476,2360
Bacau,COMUNA,TATARASTI,2335,1193,1142
Bacau,COMUNA,TRAIAN,2194,1105,1089
Bacau,COMUNA,UNGURENI,3265,1674,1591
Bacau,COMUNA,URECHESTI,3217,1669,1548
Bacau,COMUNA,VALEA SEACA,3581,1775,1806
Bacau,COMUNA,VULTURENI,2015,1010,1005
Bacau,COMUNA,ZEMES,4187,2131,2056
Bihor,MUNICIPIU,ORADEA,183123,86369,96754
Bihor,MUNICIPIU,BEIUS,10051,4845,5206
Bihor,MUNICIPIU,MARGHITA,15134,7369,7765
Bihor,MUNICIPIU,SALONTA,17042,8244,8798
Bihor,ORAS,ALESD,9619,4684,4935
Bihor,ORAS,NUCET,2148,1046,1102
Bihor,ORAS,SACUENI,11113,5447,5666
Bihor,ORAS,STEI,6144,3044,3100
Bihor,ORAS,VALEA LUI MIHAI,9688,4637,5051
Bihor,ORAS,VASCAU,2291,1103,1188
Bihor,COMUNA,ABRAM,2763,1371,1392
Bihor,COMUNA,ABRAMUT,3041,1500,1541
Bihor,COMUNA,ASTILEU,3477,1746,1731
Bihor,COMUNA,AUSEU,3003,1480,1523
Bihor,COMUNA,AVRAM IANCU,3155,1557,1598
Bihor,COMUNA,BALC,3234,1628,1606
Bihor,COMUNA,BATAR,4686,2279,2407
Bihor,COMUNA,BIHARIA,4091,2027,2064
Bihor,COMUNA,BOIANU MARE,1318,685,633
Bihor,COMUNA,BOROD,3774,1880,1894
Bihor,COMUNA,BORS,3891,1859,2032
Bihor,COMUNA,BRATCA,5088,2469,2619
Bihor,COMUNA,BRUSTURI,3334,1650,1684
Bihor,COMUNA,BUDUREASA,2551,1261,1290
Bihor,COMUNA,BUDUSLAU,1852,898,954
Bihor,COMUNA,BULZ,2055,1018,1037
Bihor,COMUNA,BUNTESTI,4183,2107,2076
Bihor,COMUNA,CABESTI,1827,920,907
Bihor,COMUNA,CAMPANI,2411,1192,1219
Bihor,COMUNA,CAPALNA,1611,768,843
Bihor,COMUNA,CARPINET,1893,909,984
Bihor,COMUNA,CEFA,2201,1074,1127
Bihor,COMUNA,CEICA,3461,1717,1744
Bihor,COMUNA,CETARIU,2104,1035,1069
Bihor,COMUNA,CHERECHIU,2391,1165,1226
Bihor,COMUNA,CHISLAZ,3055,1495,1560
Bihor,COMUNA,CIUHOI,2285,1091,1194
Bihor,COMUNA,CIUMEGHIU,4132,2044,2088
Bihor,COMUNA,COCIUBA MARE,2678,1327,1351
Bihor,COMUNA,COPACEL,2247,1150,1097
Bihor,COMUNA,CRISTIORU DE JOS,1325,640,685
Bihor,COMUNA,CURATELE,2471,1223,1248
Bihor,COMUNA,CURTUISENI,3682,1817,1865
Bihor,COMUNA,DERNA,2555,1253,1302
Bihor,COMUNA,DIOSIG,6646,3316,3330
Bihor,COMUNA,DOBRESTI,5119,2544,2575
Bihor,COMUNA,DRAGANESTI,2889,1392,1497
Bihor,COMUNA,DRAGESTI,2541,1286,1255
Bihor,COMUNA,FINIS,3557,1756,1801
Bihor,COMUNA,GEPIU,1755,860,895
Bihor,COMUNA,GIRISU DE CRIS,3354,1680,1674
Bihor,COMUNA,HIDISELU DE SUS,3246,1610,1636
Bihor,COMUNA,HOLOD,3235,1566,1669
Bihor,COMUNA,HUSASAU DE TINCA,2241,1092,1149
Bihor,COMUNA,INEU,4214,2104,2110
Bihor,COMUNA,LAZARENI,3146,1597,1549
Bihor,COMUNA,LAZURI DE BEIUS,1502,746,756
Bihor,COMUNA,LUGASU DE JOS,3480,1758,1722
Bihor,COMUNA,LUNCA,2842,1392,1450
Bihor,COMUNA,MADARAS,2781,1382,1399
Bihor,COMUNA,MAGESTI,2681,1325,1356
Bihor,COMUNA,NOJORID,5000,2493,2507
Bihor,COMUNA,OLCEA,2720,1351,1369
Bihor,COMUNA,OSORHEI,6268,3153,3115
Bihor,COMUNA,PALEU,2446,1222,1224
Bihor,COMUNA,PIETROASA,3150,1550,1600
Bihor,COMUNA,POCOLA,1554,768,786
Bihor,COMUNA,POMEZEU,2848,1433,1415
Bihor,COMUNA,POPESTI,7022,3475,3547
Bihor,COMUNA,RABAGANI,2039,965,1074
Bihor,COMUNA,REMETEA,2863,1404,1459
Bihor,COMUNA,RIENI,3013,1498,1515
Bihor,COMUNA,ROSIA,2359,1218,1141
Bihor,COMUNA,ROSIORI,3073,1513,1560
Bihor,COMUNA,SACADAT,1851,887,964
Bihor,COMUNA,SALACEA,2985,1455,1530
Bihor,COMUNA,SALARD,4264,2080,2184
Bihor,COMUNA,SAMBATA,1443,691,752
Bihor,COMUNA,SANMARTIN,8798,4350,4448
Bihor,COMUNA,SANNICOLAU ROMAN,2058,1045,1013
Bihor,COMUNA,SANTANDREI,4729,2313,2416
Bihor,COMUNA,SARBI,2534,1202,1332
Bihor,COMUNA,SIMIAN,3763,1849,1914
Bihor,COMUNA,SINTEU,1005,502,503
Bihor,COMUNA,SOIMI,2433,1201,1232
Bihor,COMUNA,SPINUS,1248,623,625
Bihor,COMUNA,SUNCUIUS,3200,1597,1603
Bihor,COMUNA,SUPLACU DE BARCAU,4290,2127,2163
Bihor,COMUNA,TAMASEU,1963,938,1025
Bihor,COMUNA,TARCAIA,1933,937,996
Bihor,COMUNA,TARCEA,2645,1337,1308
Bihor,COMUNA,TAUTEU,3942,1934,2008
Bihor,COMUNA,TETCHEA,2977,1459,1518
Bihor,COMUNA,TILEAGD,6675,3279,3396
Bihor,COMUNA,TINCA,7017,3436,3581
Bihor,COMUNA,TOBOLIU,2044,1012,1032
Bihor,COMUNA,TULCA,2688,1336,1352
Bihor,COMUNA,UILEACU DE BEIUS,2002,967,1035
Bihor,COMUNA,VADU CRISULUI,3898,1905,1993
Bihor,COMUNA,VARCIOROG,2275,1171,1104
Bihor,COMUNA,VIISOARA,1330,669,661
BISTRITA-NASAUD,MUNICIPIU,BISTRITA,70493,34389,36104
BISTRITA-NASAUD,ORAS,BECLEAN,10403,5090,5313
BISTRITA-NASAUD,ORAS,NASAUD,9077,4352,4725
BISTRITA-NASAUD,ORAS,SANGEORZ-BAI,9413,4676,4737
BISTRITA-NASAUD,COMUNA,BISTRITA BARGAULUI,3740,1813,1927
BISTRITA-NASAUD,COMUNA,BRANISTEA,3050,1505,1545
BISTRITA-NASAUD,COMUNA,BUDACU DE JOS,2744,1374,1370
BISTRITA-NASAUD,COMUNA,BUDESTI,1851,896,955
BISTRITA-NASAUD,COMUNA,CAIANU MIC,3295,1637,1658
BISTRITA-NASAUD,COMUNA,CETATE,2307,1172,1135
BISTRITA-NASAUD,COMUNA,CHIOCHIS,3081,1579,1502
BISTRITA-NASAUD,COMUNA,CHIUZA,1842,901,941
BISTRITA-NASAUD,COMUNA,CICEU MIHAIESTI,1282,632,650
BISTRITA-NASAUD,COMUNA,CICEU-GIURGESTI,1504,729,775
BISTRITA-NASAUD,COMUNA,COSBUC,1506,728,778
BISTRITA-NASAUD,COMUNA,DUMITRA,4102,2051,2051
BISTRITA-NASAUD,COMUNA,DUMITRITA,2655,1348,1307
BISTRITA-NASAUD,COMUNA,FELDRU,7524,3873,3651
BISTRITA-NASAUD,COMUNA,GALATII BISTRITEI,2161,1053,1108
BISTRITA-NASAUD,COMUNA,ILVA MARE,2239,1104,1135
BISTRITA-NASAUD,COMUNA,ILVA MICA,3222,1621,1601
BISTRITA-NASAUD,COMUNA,JOSENII BARGAULUI,4495,2267,2228
BISTRITA-NASAUD,COMUNA,LECHINTA,5505,2744,2761
BISTRITA-NASAUD,COMUNA,LESU,2539,1351,1188
BISTRITA-NASAUD,COMUNA,LIVEZILE,4074,2071,2003
BISTRITA-NASAUD,COMUNA,LUNCA ILVEI,3058,1526,1532
BISTRITA-NASAUD,COMUNA,MAGURA ILVEI,1818,896,922
BISTRITA-NASAUD,COMUNA,MAIERU,6987,3485,3502
BISTRITA-NASAUD,COMUNA,MARISELU,2279,1108,1171
BISTRITA-NASAUD,COMUNA,MATEI,2564,1258,1306
BISTRITA-NASAUD,COMUNA,MICESTII DE CAMPIE,1076,519,557
BISTRITA-NASAUD,COMUNA,MILAS,1299,658,641
BISTRITA-NASAUD,COMUNA,MONOR,1386,648,738
BISTRITA-NASAUD,COMUNA,NEGRILESTI,2402,1228,1174
BISTRITA-NASAUD,COMUNA,NIMIGEA,5011,2453,2558
BISTRITA-NASAUD,COMUNA,NUSENI,3025,1516,1509
BISTRITA-NASAUD,COMUNA,PARVA,2367,1198,1169
BISTRITA-NASAUD,COMUNA,PETRU RARES,3304,1644,1660
BISTRITA-NASAUD,COMUNA,POIANA ILVEI,1414,714,700
BISTRITA-NASAUD,COMUNA,PRUNDU BARGAULUI,5496,2687,2809
BISTRITA-NASAUD,COMUNA,REBRA,3052,1581,1471
BISTRITA-NASAUD,COMUNA,REBRISOARA,4216,2128,2088
BISTRITA-NASAUD,COMUNA,RODNA,5733,2901,2832
BISTRITA-NASAUD,COMUNA,ROMULI,1658,859,799
BISTRITA-NASAUD,COMUNA,RUNCU SALVEI,1225,617,608
BISTRITA-NASAUD,COMUNA,SALVA,2741,1346,1395
BISTRITA-NASAUD,COMUNA,SANMIHAIU DE CIMPIE,1423,687,736
BISTRITA-NASAUD,COMUNA,SANT,3251,1619,1632
BISTRITA-NASAUD,COMUNA,SIEU,2790,1425,1365
BISTRITA-NASAUD,COMUNA,SIEU-MAGHERUS,3627,1769,1858
BISTRITA-NASAUD,COMUNA,SIEU-ODORHEI,2219,1082,1137
BISTRITA-NASAUD,COMUNA,SIEUT,2652,1334,1318
BISTRITA-NASAUD,COMUNA,SILIVASU DE CIMPIE,1000,465,535
BISTRITA-NASAUD,COMUNA,SINTEREAG,3507,1735,1772
BISTRITA-NASAUD,COMUNA,SPERMEZEU,3093,1557,1536
BISTRITA-NASAUD,COMUNA,TARLISUA,3102,1560,1542
BISTRITA-NASAUD,COMUNA,TEACA,5242,2587,2655
BISTRITA-NASAUD,COMUNA,TELCIU,5649,2825,2824
BISTRITA-NASAUD,COMUNA,TIHA BARGAULUI,5574,2799,2775
BISTRITA-NASAUD,COMUNA,URIU,3180,1550,1630
BISTRITA-NASAUD,COMUNA,URMENIS,1935,991,944
BISTRITA-NASAUD,COMUNA,ZAGRA,3402,1746,1656
Botosani,MUNICIPIU,BOTOSANI,100890,49127,51763
Botosani,MUNICIPIU,DOROHOI,22600,10913,11687
Botosani,ORAS,BUCECEA,4181,2007,2174
Botosani,ORAS,DARABANI,9523,4687,4836
Botosani,ORAS,FLAMANZI,9456,4711,4745
Botosani,ORAS,SAVENI,6704,3222,3482
Botosani,ORAS,STEFANESTI,5092,2510,2582
Botosani,COMUNA,ADASENI,1361,706,655
Botosani,COMUNA,ALBESTI,6149,3098,3051
Botosani,COMUNA,AVRAMENI,3667,1834,1833
Botosani,COMUNA,BALUSENI,4541,2254,2287
Botosani,COMUNA,BLANDESTI,1975,1002,973
Botosani,COMUNA,BRAESTI,1910,932,978
Botosani,COMUNA,BROSCAUTI,2854,1379,1475
Botosani,COMUNA,CALARASI,3482,1766,1716
Botosani,COMUNA,CANDESTI,1840,866,974
Botosani,COMUNA,CONCESTI,1748,868,880
Botosani,COMUNA,COPALAU,3985,2018,1967
Botosani,COMUNA,CORDARENI,1729,809,920
Botosani,COMUNA,CORLATENI,2175,1028,1147
Botosani,COMUNA,CORNI,6460,3282,3178
Botosani,COMUNA,COSULA,2912,1471,1441
Botosani,COMUNA,COTUSCA,4522,2240,2282
Botosani,COMUNA,CRISTESTI,4409,2228,2181
Botosani,COMUNA,CRISTINESTI,3586,1727,1859
Botosani,COMUNA,CURTESTI,4403,2194,2209
Botosani,COMUNA,DANGENI,3055,1498,1557
Botosani,COMUNA,DERSCA,3043,1463,1580
Botosani,COMUNA,DIMACHENI,1392,684,708
Botosani,COMUNA,DOBARCENI,2736,1377,1359
Botosani,COMUNA,DRAGUSENI,2481,1264,1217
Botosani,COMUNA,DURNESTI,3638,1835,1803
Botosani,COMUNA,FRUMUSICA,5480,2749,2731
Botosani,COMUNA,GEORGE ENESCU,3216,1582,1634
Botosani,COMUNA,GORBANESTI,3428,1710,1718
Botosani,COMUNA,HANESTI,2121,1089,1032
Botosani,COMUNA,HAVARNA,4478,2195,2283
Botosani,COMUNA,HILISEU-HORIA,3371,1669,1702
Botosani,COMUNA,HLIPICENI,3349,1644,1705
Botosani,COMUNA,HUDESTI,6002,2920,3082
Botosani,COMUNA,IBANESTI,3903,1898,2005
Botosani,COMUNA,LEORDA,2124,1069,1055
Botosani,COMUNA,LOZNA,1852,943,909
Botosani,COMUNA,LUNCA,4238,2074,2164
Botosani,COMUNA,MANOLEASA,3224,1572,1652
Botosani,COMUNA,MIHAI EMINESCU,6807,3402,3405
Botosani,COMUNA,MIHAILENI,2286,1123,1163
Botosani,COMUNA,MIHALASENI,2206,1083,1123
Botosani,COMUNA,MILEANCA,2677,1340,1337
Botosani,COMUNA,MITOC,1854,905,949
Botosani,COMUNA,NICSENI,2610,1301,1309
Botosani,COMUNA,PALTINIS,2734,1296,1438
Botosani,COMUNA,POMARLA,2622,1323,1299
Botosani,COMUNA,PRAJENI,3097,1548,1549
Botosani,COMUNA,RACHITI,4237,2127,2110
Botosani,COMUNA,RADAUTI-PRUT,3266,1571,1695
Botosani,COMUNA,RAUSENI,2787,1372,1415
Botosani,COMUNA,RIPICENI,1899,962,937
Botosani,COMUNA,ROMA,3249,1629,1620
Botosani,COMUNA,ROMANESTI,1905,940,965
Botosani,COMUNA,SANTA MARE,2637,1332,1305
Botosani,COMUNA,SENDRICENI,3851,1939,1912
Botosani,COMUNA,STAUCENI,3606,1830,1776
Botosani,COMUNA,STIUBIENI,2645,1302,1343
Botosani,COMUNA,SUHARAU,4779,2300,2479
Botosani,COMUNA,SULITA,3020,1508,1512
Botosani,COMUNA,TODIRENI,3272,1647,1625
Botosani,COMUNA,TRUSESTI,5136,2547,2589
Botosani,COMUNA,TUDORA,5065,2652,2413
Botosani,COMUNA,UNGURENI,6605,3325,3280
Botosani,COMUNA,UNTENI,2737,1377,1360
Botosani,COMUNA,VACULESTI,1916,934,982
Botosani,COMUNA,VARFU CAMPULUI,3389,1623,1766
Botosani,COMUNA,VIISOARA,1922,958,964
Botosani,COMUNA,VLADENI,4468,2199,2269
Botosani,COMUNA,VLASINESTI,3079,1499,1580
Botosani,COMUNA,VORNICENI,3962,1992,1970
Botosani,COMUNA,VORONA,7322,3710,3612
Brasov,MUNICIPIU,BRASOV,227961,108746,119215
Brasov,MUNICIPIU,CODLEA,19836,10002,9834
Brasov,MUNICIPIU,FAGARAS,28330,13458,14872
Brasov,MUNICIPIU,SACELE,26907,13196,13711
Brasov,ORAS,GHIMBAV,4539,2217,2322
Brasov,ORAS,PREDEAL,4433,2116,2317
Brasov,ORAS,RASNOV,14081,6938,7143
Brasov,ORAS,RUPEA,5011,2401,2610
Brasov,ORAS,VICTORIA,7067,3455,3612
Brasov,ORAS,ZARNESTI,21681,10749,10932
Brasov,COMUNA,APATA,2989,1491,1498
Brasov,COMUNA,AUGUSTIN,1716,859,857
Brasov,COMUNA,BECLEAN,1790,879,911
Brasov,COMUNA,BOD,3771,1872,1899
Brasov,COMUNA,BRAN,4846,2392,2454
Brasov,COMUNA,BUDILA,4114,2121,1993
Brasov,COMUNA,BUNESTI,2305,1182,1123
Brasov,COMUNA,CATA,2399,1199,1200
Brasov,COMUNA,CINCU,1540,754,786
Brasov,COMUNA,COMANA,2556,1275,1281
Brasov,COMUNA,CRISTIAN,4315,2082,2233
Brasov,COMUNA,CRIZBAV,2379,1203,1176
Brasov,COMUNA,DRAGUS,1147,588,559
Brasov,COMUNA,DUMBRAVITA,4468,2261,2207
Brasov,COMUNA,FELDIOARA,5685,2886,2799
Brasov,COMUNA,FUNDATA,839,429,410
Brasov,COMUNA,HALCHIU,4104,2063,2041
Brasov,COMUNA,HARMAN,5202,2577,2625
Brasov,COMUNA,HARSENI,2034,1034,1000
Brasov,COMUNA,HOGHIZ,4852,2408,2444
Brasov,COMUNA,HOLBAV,1247,646,601
Brasov,COMUNA,HOMOROD,2119,1063,1056
Brasov,COMUNA,JIBERT,2127,1083,1044
Brasov,COMUNA,LISA,1681,846,835
Brasov,COMUNA,MAIERUS,2817,1430,1387
Brasov,COMUNA,MANDRA,2629,1288,1341
Brasov,COMUNA,MOIECIU,4621,2346,2275
Brasov,COMUNA,ORMENIS,1936,985,951
Brasov,COMUNA,PARAU,1779,887,892
Brasov,COMUNA,POIANA MARULUI,3199,1690,1509
Brasov,COMUNA,PREJMER,8114,4023,4091
Brasov,COMUNA,RACOS,3179,1593,1586
Brasov,COMUNA,RECEA,3006,1500,1506
Brasov,COMUNA,SAMBATA DE SUS,1505,763,742
Brasov,COMUNA,SANPETRU,4585,2275,2310
Brasov,COMUNA,SERCAIA,2733,1374,1359
Brasov,COMUNA,SINCA,3202,1594,1608
Brasov,COMUNA,SINCA NOUA,1653,838,815
Brasov,COMUNA,SOARS,1692,873,819
Brasov,COMUNA,TARLUNGENI,7820,3899,3921
Brasov,COMUNA,TELIU,4009,2008,2001
Brasov,COMUNA,TICUSU,878,458,420
Brasov,COMUNA,UCEA,2126,1057,1069
Brasov,COMUNA,UNGRA,1865,950,915
Brasov,COMUNA,VAMA BUZAULUI,3163,1619,1544
Brasov,COMUNA,VISTEA,1917,952,965
Brasov,COMUNA,VOILA,2503,1237,1266
Brasov,COMUNA,VULCAN,4440,2260,2180
Braila,MUNICIPIU,BRAILA,168389,80944,87445
Braila,ORAS,FAUREI,3411,1684,1727
Braila,ORAS,IANCA,10049,4986,5063
Braila,ORAS,INSURATEI,6332,3247,3085
Braila,COMUNA,BARAGANUL,3016,1504,1512
Braila,COMUNA,BERTESTII DE JOS,3044,1561,1483
Braila,COMUNA,BORDEI VERDE,2608,1322,1286
Braila,COMUNA,CAZASU,2877,1456,1421
Braila,COMUNA,CHISCANI,5070,2533,2537
Braila,COMUNA,CIOCILE,2723,1345,1378
Braila,COMUNA,CIRESU,3036,1465,1571
Braila,COMUNA,DUDESTI,3448,1775,1673
Braila,COMUNA,FRECATEI,1298,677,621
Braila,COMUNA,GALBENU,3052,1523,1529
Braila,COMUNA,GEMENELE,1782,889,893
Braila,COMUNA,GRADISTEA,2236,1070,1166
Braila,COMUNA,GROPENI,3210,1567,1643
Braila,COMUNA,JIRLAU,2963,1435,1528
Braila,COMUNA,MARASU,2834,1451,1383
Braila,COMUNA,MAXINENI,3163,1582,1581
Braila,COMUNA,MIRCEA VODA,3107,1575,1532
Braila,COMUNA,MOVILA MIRESII,3976,2015,1961
Braila,COMUNA,RACOVITA,1137,548,589
Braila,COMUNA,RIMNICELU,2034,993,1041
Braila,COMUNA,ROMANU,1711,849,862
Braila,COMUNA,ROSIORI,2747,1344,1403
Braila,COMUNA,SALCIA TUDOR,2512,1256,1256
Braila,COMUNA,SCORTARU NOU,1207,573,634
Braila,COMUNA,SILISTEA,1587,796,791
Braila,COMUNA,STANCUTA,3364,1698,1666
Braila,COMUNA,SURDILA-GAISEANCA,2440,1171,1269
Braila,COMUNA,SURDILA-GRECI,1453,716,737
Braila,COMUNA,SUTESTI,4211,2075,2136
Braila,COMUNA,TICHILESTI,3774,2046,1728
Braila,COMUNA,TRAIAN,3264,1647,1617
Braila,COMUNA,TUDOR VLADIMIRESCU,2034,991,1043
Braila,COMUNA,TUFESTI,5086,2525,2561
Braila,COMUNA,ULMU,3762,1854,1908
Braila,COMUNA,UNIREA,2312,1151,1161
Braila,COMUNA,VADENI,3974,2001,1973
Braila,COMUNA,VICTORIA,3656,1854,1802
Braila,COMUNA,VISANI,2398,1175,1223
Braila,COMUNA,VIZIRU,5589,2799,2790
Braila,COMUNA,ZAVOAIA,3049,1497,1552
Buzau,MUNICIPIUL,BUZAU,108384,51609,56775
Buzau,MUNICIPIUL,RAMNICU SARAT,31256,15063,16193
Buzau,ORAS,NEHOIU,9959,4926,5033
Buzau,ORAS,PATARLAGELE,7135,3451,3684
Buzau,ORAS,POGOANELE,6926,3420,3506
Buzau,COMUNA,AMARU,2579,1279,1300
Buzau,COMUNA,BALACEANU,1567,765,802
Buzau,COMUNA,BALTA ALBA,2481,1193,1288
Buzau,COMUNA,BECENI,4301,2099,2202
Buzau,COMUNA,BERCA,8236,3937,4299
Buzau,COMUNA,BISOCA,2732,1401,1331
Buzau,COMUNA,BLAJANI,1108,539,569
Buzau,COMUNA,BOLDU,2307,1108,1199
Buzau,COMUNA,BOZIORU,1155,568,587
Buzau,COMUNA,BRADEANU,2491,1206,1285
Buzau,COMUNA,BRAESTI,2308,1154,1154
Buzau,COMUNA,BREAZA,2848,1412,1436
Buzau,COMUNA,BUDA,2741,1366,1375
Buzau,COMUNA,C.A. ROSETTI,3513,1737,1776
Buzau,COMUNA,CALVINI,4363,2187,2176
Buzau,COMUNA,CANESTI,885,441,444
Buzau,COMUNA,CATINA,2501,1273,1228
Buzau,COMUNA,CERNATESTI,3776,1797,1979
Buzau,COMUNA,CHILIILE,614,290,324
Buzau,COMUNA,CHIOJDU,3459,1716,1743
Buzau,COMUNA,CILIBIA,1803,924,879
Buzau,COMUNA,CISLAU,4461,2180,2281
Buzau,COMUNA,COCHIRLEANCA,4898,2415,2483
Buzau,COMUNA,COLTI,1082,516,566
Buzau,COMUNA,COSTESTI,4609,2288,2321
Buzau,COMUNA,COZIENI,2090,1020,1070
Buzau,COMUNA,FLORICA,1576,761,815
Buzau,COMUNA,GALBINASI,3998,1990,2008
Buzau,COMUNA,GHERASENI,3392,1717,1675
Buzau,COMUNA,GHERGHEASA,2426,1172,1254
Buzau,COMUNA,GLODEANU SARAT,4376,2162,2214
Buzau,COMUNA,GLODEANU-SILISTEA,3902,1881,2021
Buzau,COMUNA,GREBANU,5066,2531,2535
Buzau,COMUNA,GURA TEGHII,3374,1662,1712
Buzau,COMUNA,LARGU,1482,743,739
Buzau,COMUNA,LOPATARI,4108,2089,2019
Buzau,COMUNA,LUCIU,2858,1471,1387
Buzau,COMUNA,MAGURA,2070,1020,1050
Buzau,COMUNA,MANZALESTI,2553,1264,1289
Buzau,COMUNA,MARACINENI,7976,3954,4022
Buzau,COMUNA,MARGARITESTI,685,331,354
Buzau,COMUNA,MEREI,6607,3256,3351
Buzau,COMUNA,MIHAILESTI,2020,1003,1017
Buzau,COMUNA,MOVILA BANULUI,2604,1267,1337
Buzau,COMUNA,MURGESTI,933,438,495
Buzau,COMUNA,NAENI,1779,865,914
Buzau,COMUNA,ODAILE,861,417,444
Buzau,COMUNA,PADINA,3914,1898,2016
Buzau,COMUNA,PANATAU,2514,1231,1283
Buzau,COMUNA,PARDOSI,439,213,226
Buzau,COMUNA,PARSCOV,5493,2684,2809
Buzau,COMUNA,PIETROASELE,3199,1518,1681
Buzau,COMUNA,PODGORIA,3112,1529,1583
Buzau,COMUNA,POSTA CALNAU,5783,2851,2932
Buzau,COMUNA,PUIESTI,4063,1916,2147
Buzau,COMUNA,RACOVITENI,1393,678,715
Buzau,COMUNA,RAMNICELU,4444,2165,2279
Buzau,COMUNA,ROBEASCA,1108,554,554
Buzau,COMUNA,RUSETU,3628,1764,1864
Buzau,COMUNA,SAGEATA,4789,2437,2352
Buzau,COMUNA,SAHATENI,3159,1543,1616
Buzau,COMUNA,SAPOCA,3212,1600,1612
Buzau,COMUNA,SARULESTI,1314,671,643
Buzau,COMUNA,SCORTOASA,3008,1466,1542
Buzau,COMUNA,SCUTELNICI,2242,1105,1137
Buzau,COMUNA,SIRIU,3139,1582,1557
Buzau,COMUNA,SMEENI,6469,3243,3226
Buzau,COMUNA,STALPU,3089,1508,1581
Buzau,COMUNA,TINTESTI,4367,2196,2171
Buzau,COMUNA,TISAU,4616,2314,2302
Buzau,COMUNA,TOPLICENI,3839,1892,1947
Buzau,COMUNA,ULMENI,3120,1520,1600
Buzau,COMUNA,UNGURIU,2376,1210,1166
Buzau,COMUNA,VADU PASII,9065,4473,4592
Buzau,COMUNA,VALCELELE,1546,732,814
Buzau,COMUNA,VALEA RAMNICULUI,5207,2590,2617
Buzau,COMUNA,VALEA SALCIEI,763,364,399
Buzau,COMUNA,VERNESTI,8237,4049,4188
Buzau,COMUNA,VINTILA VODA,3056,1512,1544
Buzau,COMUNA,VIPERESTI,3404,1711,1693
Buzau,COMUNA,ZARNESTI,5424,2718,2706
Buzau,COMUNA,ZIDURI,4305,2146,2159
